
###############
#P    1      1#
#   ## ##   # #
#    2M2    # #
#   ##2##   # #
#    # #    # #
#           #M#
###############
