###############
#P          #M#
###  ####   # #
###  ####  ## #
#         1   #
# #######  ## #
#  2      12# #
###############