###############
#P    6#      #
#    63       #
#  #5413      #
#  54121      #
#      2      #
#             #
###############