###############
#P         2  #
#  3#       # #
#   #      5# #
# # #  #5#  # #
# #5#  # #  #2#
#            3#
###############